

0,0 _,3,L,_
0,3 1,0,_,R
1,0 2,2,R,U


2,0 _,3,R,U
2,3 3,_,L,D
0,2 1,_,R,_


3,2 3,2,R,D
3,0 _,3,R,D
3,3 2,_,L,U

1,3 _,_,_,U
1,2 _,3,_,R



0,1 2,2,_,_
1,1 2,2,_,_
3,1 2,2,_,_
2,1 2,2,_,_

2,2 _,_,_,_


% available: n/a