0,0 1,1,_,R
1,0 2,2,_,D
2,0 3,3,_,R
3,0 4,4,_,U
4,0 0,1,_,L
0,2 5,_,_,U
5,0 2,0,_,U