

0,0 1,_,_,R


1,0 1,1,R,_

1,1 3,_,L,_

1,3 _,_,_,U

3,0 _,2,L,U

3,2 2,_,R,D

3,3 0,_,L,D

2,0 _,2,L,D

2,2 3,_,R,U

3,1 1,2,_,_

1,2 _,_,_,_




