0,0 3,_,_,D

3,0 2,3,R,_
0,3 3,2,_,R

3,1 2,_,R,_
0,1 2,_,R,_

1,3 _,2,_,R
1,0 _,2,_,R

1,1 5,_,L,L
2,2 _,_,L,_

0,2 4,_,L,L


4,3 _,_,R,_
2,0 6,1,R,R
2,3 6,_,R,_

5,3 _,4,L,_
5,0 _,4,L,_
5,4 6,_,L,_

6,0 5,_,R,_
6,4 2,_,L,_

4,4 5,0,R,_

2,4 4,1,_,R

4,0 2,1,_,_

2,1 _,_,_,_



