0,0 3,_,_,D

3,0 2,3,R,_
0,3 3,_,_,R

3,1 2,_,R,_
0,1 2,_,R,_

1,3 _,_,_,R
1,0 _,_,_,R

1,1 2,_,_,D
2,0 _,1,L,R

2,3 _,_,_,_