

0,0 2,_,_,R


2,0 1,2,R,_

1,0 _,1,R,U

2,2 3,_,L,D

3,3 _,_,R,_

0,3 2,_,_,R

3,0 _,2,L,D

3,2 _,_,R,U

1,3 2,3,_,_

2,1 1,2,_,_
3,1 1,2,_,_

1,2 _,_,_,_
2,3 _,_,_,_