
0,0 2,3,_,D

2,0 _,3,R,_

0,3 3,4,D,U

0,2 _,_,_,D

0,4 _,3,U,D

3,4 _,3,U,D

3,0 4,_,L,R

2,3 _,_,R,_

4,3 3,_,R,L

4,0 3,_,R,L


4,1 _,2,_,_
2,1 _,2,_,_
4,2 _,_,_,_

1,4 2,_,_,_
1,2 2,_,_,_
2,4 _,_,_,_

2,2 _,_,_,_