0,0 0,2,_,R
0,1 0,1,R,R
2,0 0,0,R,R
1,0 1,1,_,_
1,1 1,1,_,_
