
0,0 _,2,L,_
0,2 1,0,_,R

1,0 3,3,R,U


%0,1 1,_,_,R

3,0 _,2,R,U
3,2 2,_,L,D
0,3 1,_,R,_


2,3 2,4,R,D
2,0 _,2,R,D
2,2 3,_,L,U

1,2 _,_,_,U
1,4 _,2,_,R



0,1 4,2,_,_
1,1 4,2,_,_
3,1 4,2,_,_
2,1 4,2,_,_

4,2 _,_,_,_


% 0,0 3,_,_,R